13 16 3
4 4
0 0 0 0 0 0 0 0 0 0 0 0 0 
0 1 1 1 1 1 1 1 1 1 1 1 1  
0 1 1 1 1 1 1 1 1 1 1 1 1  
0 1 1 1 1 1 1 1 1 1 1 1 1  
0 1 1 1 1 1 1 1 1 1 1 1 1  
0 1 1 1 1 1 1 1 1 1 1 1 1  
0 1 1 1 1 1 1 1 1 1 1 1 1   
0 1 1 1 1 1 1 1 1 1 1 1 1   
0 1 1 1 1 1 1 1 1 1 1 1 1   
0 1 1 1 1 1 1 1 1 1 1 1 1   
0 1 1 1 1 1 1 1 1 1 1 1 1   
0 1 1 1 1 1 1 1 1 1 1 1 1  
0 0 0 0 0 0 0 0 0 0 1 1 1   
0 0 0 0 0 0 0 0 0 0 1 1 1   
0 0 0 0 0 0 0 0 0 0 1 1 1   
0 0 0 0 0 0 0 0 0 0 1 1 1   

0 0 1002 1000 1000 1000 1000 1000 1000 1000 1000 1000 1000   
1001 0 1001 3 0 0 0 0 0 0 0 0 0 
1001 0 1001 3 0 0 0 0 0 0 0 0 0   
1001 0 1001 3 0 0 0 0 0 0 0 0 0   
1001 0 1001 0 0 0 0 0 0 0 0 0 0   
1001 0 1001 0 0 0 0 0 0 0 0 0 0   
1001 0 0 0 0 0 0 0 0 0 0 0 0   
1001 0 0 0 0 0 0 0 0 0 0 0 0   
1001 0 0 0 0 0 0 0 0 0 0 0 0   
1001 0 0 0 0 0 0 0 0 0 0 0 0   
1001 0 0 0 0 0 0 0 0 0 0 0 0   
1001 0 3 3 3 3 3 3 3 3 0 0 0   
0 0 0 0 0 0 0 0 0 0 0 0 0  
0 0 0 0 0 0 0 0 0 0 0 0 0  
0 0 0 0 0 0 0 0 0 0 0 0 0  
0 0 0 0 0 0 0 0 0 0 0 0 0  

0 0 0 0 0 0 0 0 0 0 0 0 0   
0 0 0 0 0 0 0 0 0 0 0 0 0   
0 0 0 0 0 0 0 0 0 0 0 0 0   
0 0 0 0 0 0 0 0 0 0 0 0 0   
0 0 0 0 0 0 0 0 0 0 0 0 0   
0 0 0 0 0 0 0 0 0 0 0 0 0   
0 0 0 0 0 0 0 0 0 0 0 0 0   
0 0 0 0 0 0 0 0 0 0 0 0 0  
0 0 0 0 0 0 0 0 0 0 0 0 0   
0 0 0 0 0 0 0 0 0 0 0 0 0   
0 0 0 0 0 0 0 0 0 0 0 0 0   
0 0 0 0 0 0 0 0 0 0 0 0 0   
0 0 0 0 0 0 0 0 0 0 0 0 0   
0 0 0 0 0 0 0 0 0 0 0 0 0  
0 0 0 0 0 0 0 0 0 0 0 0 0   
0 0 0 0 0 0 0 0 0 0 0 0 0   



