12 16 3
4 4
0 0 0 0 0 0 0 0 0 0 0 0 
0 1 1 1 1 1 1 1 1 1 1 1   
0 1 1 1 1 1 1 1 1 1 1 1   
0 1 1 1 1 1 1 1 1 1 1 1   
0 1 1 1 1 1 1 1 1 1 1 1   
0 1 1 1 1 1 1 1 1 1 1 1   
0 1 1 1 1 1 1 1 1 1 1 1    
0 1 1 1 1 1 1 1 1 1 1 1    
0 1 1 1 1 1 1 1 1 1 1 1    
0 1 1 1 1 1 1 1 1 1 1 1    
0 1 1 1 1 1 1 1 1 1 1 1    
0 1 1 1 1 1 1 1 1 1 1 1   
0 0 0 0 0 0 0 0 0 0 1 1    
0 0 0 0 0 0 0 0 0 0 1 1    
0 0 0 0 0 0 0 0 0 0 1 1    
0 0 0 0 0 0 0 0 0 0 1 1    

0 0 1002 1000 1000 1000 1000 1000 1000 1000 1000 1000    
1001 0 1001 2 0 0 2 2 2 2 0 0 
1001 0 1001 2 0 0 0 0 0 0 0 0    
1001 0 1001 0 0 0 0 0 0 0 0 0    
1001 0 1001 0 0 0 0 0 0 0 0 0    
1001 0 0 0 0 0 0 0 0 0 0 0    
1001 0 0 0 0 0 0 0 0 0 0 2    
1001 0 0 0 0 0 0 0 0 0 0 2    
1001 0 0 0 0 0 0 2 0 0 0 2    
1001 0 0 0 0 0 0 0 0 0 0 0    
1001 0 0 0 0 0 0 0 0 0 0 0    
1001 2 2 2 2 2 2 2 2 0 0 0    
0 0 0 0 0 0 0 0 0 0 0 0   
0 0 0 0 0 0 0 0 0 0 0 0   
0 0 0 0 0 0 0 0 0 0 0 0   
0 0 0 0 0 0 0 0 0 0 0 0   

0 0 0 0 0 0 0 0 0 0 0 0    
0 0 0 0 0 0 0 0 0 0 0 0    
0 0 0 0 0 0 0 0 0 0 0 0    
0 0 0 0 0 0 0 0 0 0 0 0    
0 0 0 0 0 0 0 0 0 0 0 0    
0 0 0 0 0 0 0 0 0 0 0 0    
0 0 0 0 0 0 0 0 0 0 0 0    
0 0 0 0 0 0 0 0 0 0 0 0   
0 0 0 0 0 0 0 0 0 0 0 0    
0 0 0 0 0 0 0 0 0 0 0 0    
0 0 0 0 0 0 0 0 0 0 0 0    
0 0 0 0 0 0 0 0 0 0 0 0    
0 0 0 0 0 0 0 0 0 0 0 0    
0 0 0 0 0 0 0 0 0 0 0 0  
0 0 0 0 0 0 0 0 0 0 0 0    
0 0 0 0 0 0 0 0 0 0 0 0   



