5 7 3
2 2
0 0 0 0 0
0 1 1 1 1
0 1 1 1 1
0 1 1 1 1
0 2 1 1 1
0 2 2 1 1
0 1 1 1 1

5 5 5 5 5
5 0 0 3 3
5 0 0 0 0
5 0 0 0 0
5 0 0 0 0
5 0 0 2 0
5 0 0 0 0

0 0 0 0 0
0 0 0 4 0
0 0 0 0 0
0 0 0 0 0
0 0 0 0 0
2 0 0 0 0
2 0 0 0 0 